00000000000000000000
00000000011111111000
00000000010000001000
11111100010000001000
00000100010000001000
00000100010000001000
00000100010000001000
00000111110000001000
00000000000000001000
00001111000000001000
00001001000000001000
00001001000000001000
00001001111111111000
00001000000000000000
00001000000000000000
00001000000000000000
00001111111111000000
00000000000001000000
00000000000001000000
00000000000009000000